1111111111111111111111111111111
1P00000010001010000010000000001
1011101010101010101011101111101
1010001010101000101000101000101
1110111010101111101110101110101
1000101000100000101000100010101
1011101111111110101011111010101
1010000000000010101010000010101
1011111110111010101011101110101
1000000010001010001000101000101
1111111011101111111110101011101
1010001000100C00000000101010001
1010101010101110111111101010111
1010000000100010100000000010101
1011111111101110101111111010101
1000100000101000000000001010101
1010101110101011111111101010101
101000101000101000100000100E101
1111111111111111111111111111111